+---+------------+----+
| x |            |    |
|   +  +-----+   |    |
|      +        +++   |
|   +   ++            |
+-- +-+  |  +----+    |
|        +           o|
|   +          +      |
+---+----------+------+